"filename", "language", "PostCSS", "TypeScript", "JavaScript", "comment", "blank", "total"
"c:\Users\gregc\Documents\js_dev\phaser_dev\RPG2\dist\assets\index-B1XaOpIx.js", "JavaScript", 0, 0, -1, 0, -1, -2
"c:\Users\gregc\Documents\js_dev\phaser_dev\RPG2\dist\assets\index-DHyIjCu8.js", "JavaScript", 0, 0, 1, 0, 1, 2
"c:\Users\gregc\Documents\js_dev\phaser_dev\RPG2\src\customStyles\sceneTransition.css", "PostCSS", 29, 0, 0, 0, 4, 33
"c:\Users\gregc\Documents\js_dev\phaser_dev\RPG2\src\game_scripts\SceneActionManager.ts", "TypeScript", 0, 4, 0, 1, 0, 5
"c:\Users\gregc\Documents\js_dev\phaser_dev\RPG2\src\game_scripts\SceneTransition.ts", "TypeScript", 0, 32, 0, 5, 6, 43
"c:\Users\gregc\Documents\js_dev\phaser_dev\RPG2\src\game_scripts\character.ts", "TypeScript", 0, 46, 0, -5, 5, 46
"c:\Users\gregc\Documents\js_dev\phaser_dev\RPG2\src\game_scripts\utils\CollisionChecker.ts", "TypeScript", 0, 25, 0, 3, 2, 30
"c:\Users\gregc\Documents\js_dev\phaser_dev\RPG2\src\game_scripts\utils\DesktopControls.ts", "TypeScript", 0, 257, 0, 16, 34, 307
"c:\Users\gregc\Documents\js_dev\phaser_dev\RPG2\src\game_scripts\utils\SceneUtils.ts", "TypeScript", 0, 45, 0, 0, 6, 51
"c:\Users\gregc\Documents\js_dev\phaser_dev\RPG2\src\game_scripts\utils\utils.ts", "TypeScript", 0, 7, 0, 2, 2, 11
"c:\Users\gregc\Documents\js_dev\phaser_dev\RPG2\src\scenes\MainGameScene.ts", "TypeScript", 0, -61, 0, 18, -4, -47
"Total", "-", 29, 355, 0, 40, 55, 479